%%%%%%%%%%%%%%%%%%%%
%%%&&&&%%%%%%%&&&%%%
%%%&&&&%%%%%%%&&&%%%
%%%%%%&%%%%%%%&%%%%%
%%%%%%&%%%%%%%&%%%%%
%%%%%%&%%%%&&&&&%%%%
%&&%%%&&&&&&&&&&%%%%
%&&%%%&&%%%&&&&&%%%%
%&&&&&&&%%%&&&&&%%%%
%&&%%%&&%%%&&&&&%%%%
%&&%%%&&%%%%%%%%%%%%
%%%%%%&&&&&&&&&%%%%%
%%%%%%&&%%%%&&&%%%%%
%%%%%%&&%%%%&&&%%%%%
%%%%%%&&%%%%%%%%%%%%
%%%%%%&&%%%%%%%%%%%%
%%&&&&&&&&&&&&&&&&%%
%%&&&&%%%%%%%%&&&&%%
%%%%%%%%%%%%%%%%%%%%
%%%%%%%%%%%%%%%%%%%%
